10x20
********************
*  R *     *     R *
*    *     +    ****
*          +  R    *
*++**   ****       O
*                  *
*     +++     +    *
*    H  *  R *++*  *
*       *          *
********************